111111111111111111111111111111111111111
1       S          1                 *1
1                  1                  1
1                  1                  1
1                                     1
1                                     1
1                                     1
1                                     1
1               1111                  1
1                  1                  1
1                                     1
1                                     1
1                                     1
1                                     1
1                   11111111          1
1                                     1
1                         1           1
1                         1           1
1                        1G           1
111111111111111111111111111111111111111
